100000000000000000001
102222222202222222201
103002000202000200301
102222222222222222201
102002020000020200201
102222022202220222201
100002000101000200001
111102011111110201111
000002010010010200000
111112110111011211111
000002010000010200000
111102011111110201111
100002010000010200001
102222222202222222201
102002000202000200201
103202222222222202301
100202020000020202001
102222022202220222201
102000000202000000201
102222222222222222201
100000000000000000001
