11111111111111111111111
11000000000000000000011
11022222222022222222011
11030020002020002003011
11022222222222222222011
11020020200000202002011
11022220222022202222011
11000020001010002000011
11111020111111102011111
00000020100400102000000
11111121101110112111111
00000020100000102000000
11111020111111102011111
11000020100000102000011
11022222222022222222011
11020020002020002002011
11032022222222222023011
11002020200000202020011
11022220222022202222011
11020000002020000002011
11022222222222222222011
11000000000000000000011
11111111111111111111111
11111111111111111111111
