000000000000000000000
002222222202222222200
003002000202000200200
002222222222222222200
002002020000020200200
002222022202220222200
000002000101000200000
000002011111110200000
000002010000010200000
111112110111011211111
000002011111110200000
000002010000010200000
002222222202222222200
002002000202000200200
003202222222222202300
000202020000020202000
002222022202220222200
002000000202000000200
002222222222222222200
000000000000000000000